0000200000000000
0000100000000000
0000100000000000
0300100000000000
0000100000000000
0000100000000000
0000100000000000
0400100000000000
1111100000000000
0000000000000000
0000000000000000
0000000000000000
0000000000000000
0000000000000000
0000000000000000
0000000000000000
